# vi:set ts=8 sts=8 sw=8 tw=0:
#
# han2zen.dat - 半角→全角変換表
# 
# Last Change: 14-Aug-2001.
# Written By:  Muraoka Taro  <koron@tka.att.ne.jp>

# 漢字コードの違いもこの変換表で吸収する。

# 半角→全角スペース変換はデリミタをisspace()で定義してしまったのでできてい
# ない。
# 	　
!	！
"	”
# シャープの変換はコメントとみなされるのでできていない。
#	＃
$	＄
%	％
&	＆
'	’
(	（
)	）
*	＊
+	＋
,	，
-	−
.	．
/	／
0	０
1	１
2	２
3	３
4	４
5	５
6	６
7	７
8	８
9	９
:	：
;	；
<	＜
=	＝
>	＞
?	？

@	＠
A	Ａ
B	Ｂ
C	Ｃ
D	Ｄ
E	Ｅ
F	Ｆ
G	Ｇ
H	Ｈ
I	Ｉ
J	Ｊ
K	Ｋ
L	Ｌ
M	Ｍ
N	Ｎ
O	Ｏ
P	Ｐ
Q	Ｑ
R	Ｒ
S	Ｓ
T	Ｔ
U	Ｕ
V	Ｖ
W	Ｗ
X	Ｘ
Y	Ｙ
Z	Ｚ
[	［
\	￥
]	］
^	＾
_	＿

`	‘
a	ａ
b	ｂ
c	ｃ
d	ｄ
e	ｅ
f	ｆ
g	ｇ
h	ｈ
i	ｉ
j	ｊ
k	ｋ
l	ｌ
m	ｍ
n	ｎ
o	ｏ
p	ｐ
q	ｑ
r	ｒ
s	ｓ
t	ｔ
u	ｕ
v	ｖ
w	ｗ
x	ｘ
y	ｙ
z	ｚ
{	｛
|	｜
}	｝
~	〜

｡	。
｢	「
｣	」
､	、
･	・
ｦ	ヲ
ｧ	ァ
ｨ	ィ
ｩ	ゥ
ｪ	ェ
ｫ	ォ
ｬ	ャ
ｭ	ュ
ｮ	ョ
ｯ	ッ
ｰ	ー
ｱ	ア
ｲ	イ
ｳ	ウ
ｴ	エ
ｵ	オ
ｶ	カ
ｷ	キ
ｸ	ク
ｹ	ケ
ｺ	コ
ｻ	サ
ｼ	シ
ｽ	ス
ｾ	セ
ｿ	ソ

ﾀ	タ
ﾁ	チ
ﾂ	ツ
ﾃ	テ
ﾄ	ト
ﾅ	ナ
ﾆ	ニ
ﾇ	ヌ
ﾈ	ネ
ﾉ	ノ
ﾊ	ハ
ﾋ	ヒ
ﾌ	フ
ﾍ	ヘ
ﾎ	ホ
ﾏ	マ
ﾐ	ミ
ﾑ	ム
ﾒ	メ
ﾓ	モ
ﾔ	ヤ
ﾕ	ユ
ﾖ	ヨ
ﾗ	ラ
ﾘ	リ
ﾙ	ル
ﾚ	レ
ﾛ	ロ
ﾜ	ワ
ﾝ	ン
ﾞ	゛
ﾟ	゜
